11111111111111111111
10000000000000000001
10000000000000000001
10000000000000000001
10000200000003000001
10000000000000000001
10000000000000000001
10000000000000000001
10000300000002000001
10000000000000000001
10000000000000000001
10000000000000000001
10000400000000000001
10000000000000000001
10000000000000000001
10000000000000000001
10000000000000000001
10000000000000000001
10000000000000000001
11111111111111111111
