11111111111111111
15000000100000061
10110110101101101
10000000000000001
10110101110101101
10000100100100001
11110100000101111
00000001110000000
11110100000101111
10000100100100001
10110101110101101
10000000400000001
10110110101101101
17000000100000081
11111111111111111